abstract|ledmenu|Abstract
flames|ledmenu|Flames
tunnel|ledmenu|Tunnel
ink|ledmenu|Ink
rays|ledmenu|Rays
lava|ledmenu|Lava
beachball|ledmenu|Beachball
stripes|ledmenu|Stripes
miami|ledmenu|Miami
spark|ledmenu|Spark
plasma|ledmenu|Plasma
prism|ledmenu|Prism
paint|ledmenu|Paint
clouds|ledmenu|Clouds
spectro|ledmenu|Spectro
noise1|ledmenu|Noise #1
noise2|ledmenu|Noise #2
noise3|ledmenu|Noise #3
blur|ledmenu|Blur
gas|ledmenu|Gas
water|ledmenu|Water
bubbles|ledmenu|Bubbles
ripple|ledmenu|Ripple
blocks|ledmenu|Blocks
lumin|ledmenu|Lumin
warp|ledmenu|Warp
gold|ledmenu|Gold
rave|ledmenu|Rave
spectrum|ledmenu|Spectrum
spotlight|ledmenu|Spotlight
mandelbrot|ledmenu|Mandelbrot
particle|ledmenu|Particle
chase|ledmenu|Chase
rainbow|ledmenu|Rainbow
orbits|ledmenu|Orbits
flash|ledmenu|Flash
strobe|ledmenu|Strobe
vibrant|ledmenu|Vibrant
voltage|ledmenu|Voltage
8bit|ledmenu|8-Bit
rings|ledmenu|Rings
pixel|ledmenu|Pixel
fuse|ledmenu|Fuse